11111111111111111111
1000C0000010101C01P1
10011110000000001001
1001C0000E0010000011
11111111111111111111